1111111111111111111111111111111111111111111111111111111111111111111111111111111111111111111111111111
0100000000000000110011000010000001000000001001001001000000010001010110001010000110100001100110100011
0000100000010010100100000000000000100000000000010000100010010110000001010000000101100000000000000011
1100000010100000101001010000000101000011110100111011100000000000000000000000000000000000000000000111
1000000100000000000100100000000010101010000001000001000000010000001001110001100000000000001000000001
1000000010010000010000001100000000000001110000010110010001010000000000000000001100000010001001100001
1000001000100001000000000000010100110100001010000100001010001000000011000000010101000001010000000001
1000110010000000001000001000000000000010001000001010011000000100001101100010001000101010000011000001
1001001000000000001000010000001000000010010000101000100000000010000000000100000100100000100011001101
1001011000000001000010010010001001100001100001100001000000000101010100001110100010000101000100100101
1000001100000101000100000000000101001000000001000100111000110000000100000101011000000100001000000001
1011000001010000000001010100000000000100110100000001100001000001001000001010100000101000000000100111
1001110001000000100000100010011000000100011100101100000000000000000000000110000000001100011010000001
1001000100110000001101000011000000100010001000101000110000010000000000010100000000011000001000100011
1000100010000000111001001100111100011100000100010001001001010011000000100000100000011110000100100001
1000000000010001000000010010000001000011010000000000001001100000001000000010010010000100000000000101
1001010000000100100010001101000111001100001000000010010111000111001100100000011010000000000100001001
1100011111100001000000000100011100000111100000100100000010011110001000011000000000111000000100010001
1000010100100000100000000001010000011101000010100110000011100010000000000110110001010010100000001101
1000010001100000010001100010000001010100001000000000110001000000010100000010001000001110000000000001
1000010101001101000000100000101100000100100000100000000010000001000100001011001001010000000010010001
1100000000000011000000000001001000001111000100000100010010010001100000010110001010010101000100110001
1000000000100000100001000100000100001000000000001010011110010000011011110000000001000000010000011001
1000000000001000100000100101000010000100001010100000100100000001110000000000001010001100010010001001
1100000000000101100011001000010000010110001010010100000001000110000000000001010000011001101000001101
1011001000000010001001000010010010000010001000000000000000001010000101000001001101000100010001101001
1100010010100011101000000000010100110000000000110000110000110010000101010000010100101100100110000011
1001110100100000000000000101000100001000010011010101011000000000010111000000000000001010000001100001
1001011100000100000010000100000000111000100111001001000011110001011000000000001100001010001100101001
1000000000001001000000001110000000100000100110001000010011000010000000010110000100110101100000100011
1100000000000000100101100000000101000001000000000000101000000000001000011000000000000100100111000001
1001100100000001000100100001110100000000001001000000000000100100000100001001010000101000000000000001
1000010000000000011000000001000010100011110001001000000000000000001000000000001001000100000100111001
1001001010000100000000000010000100001101100001010100010000010010001001001000001000100000000000000011
1000010000111000000101100000000000001000101100000000000000110000100100000001010000100000111001010111
1100010101000000000000001000010000111010000000000010100001101000011001000010101000100000100101101001
1000000100000001010000000000010100110000100010010000100000101010000100000100100000000000100000110001
1100100101010000010100011010000001000000000000000001000010000000011000101001000001000010011100100101
1000000000000110000110110001100000100001100000000001000100001010000000011100000011001100000110000001
1001100001000000010000010000000000100000000000000100000100000010011011000000000001000010110111000001
1001000000011010000101011000000100100110000110010000001100000000010110000101000000000001000000000001
1100001110101000001010000110001011000101010000001010000000000011000000000010110010000010011100000001
1100010000100000011001000101000000001001100001000000011000110000001000000000100110000000000001011111
1010101010110100000000000100100000010000000001001000000000000000100001000100100010000000100100001001
1010000100010000100000000000001000100000001000010000000000010000000101000001000000000000011010010001
1000100001101010000000101000100000010000000000110000100000000100000010000010000011011001000010010011
1001001111101000001000010011000010101001000110010000111010000101100001001000101001001110000000001101
1100010010000000110000000000100110001000000100101010000100000000001110100000000000010100000000001101
1010000000010111000100000000010000000010010000011000000100000001000100000001100000000000100101000001
1100000100000011110010010101001101000000000100100100000000000000000011110100010010010000000010000011
1110000101000010111000000100101001000010000000100010000011010000000101111000100000111100101100010001
1000000000000000000000100011001100100010100010010000000010100000001000100000000000000101001000010011
1000010000010001110100001111100110000100000001000100101101100000110000001001010000000110000000001001
1001100010101010000001010100101000100000010000000001001000000000000100001001000000110000000001100101
1010000001100000100000000011010110010000000101011100000000100100100001100000000000111000010001000101
1101000000000110100001110100010010110010000000000100111001000100000100100000000000010111010001101111
1001001001001001000010100000101000100010110111000000010000010010000000010010100000100110001010100001
1101000000010011001111001001000000010101000000100000011101000100010011000000101000001000100000100001
1000000001001001000010100000011000010000001001011110100001101000000001010100000000001000100100000101
1110000100100101011001101100001011000000000001000001010000000101000000101100100000000000000001000001
1011001100001100000100010110100000000100100100000110000100111001000001100000000001000011000000010001
1100100000000010101100101000010010100000100100001100001000000000001001000100000000000000010000000001
1000000100000001011100100100100011010100000010000000010010001110101110110001000010101001110000010001
1000000101010001000100000001000100000010100011010000011000110000011000000110011000100000010000011111
1000001001110000001010110110010100100000110010010100011000010010100000100000000110001000100001000101
1000000010010100000001000000010000011100000001010100101000000000010110100010001000000110100010000001
1000001000000100001000100000010000000000010110000100011011000011100101000000110001100001010100000001
1010000000000000010100001000001010010001100010000000000011001000000000001001000000000000101000100001
1010011010000110000000010000000010000000011001000010000011101001000101010010001101001010010001000011
1100000000000000001000100101000001000000001000000011000000001000001101010100000000000000000000000101
1000001001001000011101010100001000000000010000000000000011101010110110011000000000000001000000010101
1100000001011001001000000000100111100000000000000101000000100000000100100000010000000100101101000001
1101001000000110000000110100000000000100100100011000000001000001010000011000010011000001001001110001
1100000001000100011010000000001000011100001000000110000010000000000000000010001101000000000100000001
1000000000000010100000000000010100000001100101011000000010010000000001001010000001001000000000100011
1010010000010001010001000000000100000011000001000000101000001000110011000100000000001010000001001101
1001001000010000100000000000010010010100000010000001101000010001010001000000001101000100000100000011
1000000000000010001000100101011000001110000010010000000000001101000100000000001100000100010000000001
1010000000000001000000011000000110110011000000000010010001000110000000000011000000000101000100010101
1000000000001001100011000000001100100000110000000100111000100010000010110100100100000001001101000001
1010000000000000110000000010000000000000010100000001000000000010010000010000000000000000011010000100
1100001110100000010001111010110001011000000000001101000011010000110000100000111100000100000100010101
1000010000000010100000000001001111000110000000100000000100000100000000100000100101011110001000100011
1100000110111000010100001001000000001110010000000010010010100000100111010000000000100101000000000101
1000110100011100011001000000000000010000110000000101001000100010010000001100110010001000010000111001
1000000100000100000110000010000001010000110000000010100000100000000101010100000001000010010100010001
1000110010000010000011000000001101000011011000000010000101001000010000001001100100000000010000010001
1101000101011000010100110100010010100001001000011001000000011000000000100100010001001100000001001101
1100010000000010100000111010010011100110000000001001000111000010000000000011011000011000001010000011
1110000100110010010100001000100000000001101000110011100010100001100000100000011010000000001011100011
1101010000001000000000000100010011000100010010001000011000100000000101100100010001001000010000000001
1000000100000001000101010011000000000000000000000110010000010001000000011100000100000001000000000011
1110000001010100010100000100010000100000010000001100001001000010000000100100100000000001001000100001
1010000001000000000000000010100000000100100100010110110000000010010000000001000011010000000001000001
1100000010000000100000010100101000010000000010010010000000100001000000100000001000000000000010000001
1000001000000000000000100000001101010000000010001101100100001000010000100000010100010000111000000001
1000000000100100000100001100000000000000000110000000000000100010100000000111100010000101001000001001
1011110001000010000011010001110010001000000000000000000000000000101000001010000000000000000000000101
1000010001010010000100010000100000001100000001000100000100000010010010000010000110110000101001000001
1111111111111111111111111111111111111111111111111111111111111111111111111111111111111111111111111111
